1 3 1 1	1 1 1 1	1 1 1 1	1 1 1 1	1 1 1 1	1 1 1 1	1 1 1 1	1 1
1 0 0 0	0 0 0 1	0 0 0 0	0 1 0 0	0 0 0 1 0 0 0 0	0 0 0 0	0 1
1 0 0 0	0 0 0 2	0 0 0 0	4 1 5 0 7 0 9 1 0 0 0 9 1 1 1 1 0 1
1 0 1 1	1 1 1 1	0 4 0 1	1 1 0 0	0 0 0 1	0 1 0 0	7 0 0 1	0 1
1 0 0 0	0 0 1 0	0 0 0 1	5 0 0 0	0 5 0 1	0 1 0 0 1 1 1 1 0 1
1 0 1 1	1 0 1 0	0 1 0 1	1 1 0 9	0 0 0 0	0 1 0 0	0 0 0 1	0 1
1 0 0 0	1 0 0 0	0 1 0 0	0 1 2 1	1 1 1 1	1 1 0 0	1 1 1 1	2 1
1 0 0 1	1 1 1 2	1 1 0 1	1 1 0 0	0 0 0 0	0 0 0 0	0 0 0 0	0 1
1 0 0 2	0 0 0 0	0 1 0 0	0 1 0 1	0 7 0 9	0 0 0 9	5 0 4 0	0 1
1 2 1 1	1 1 1 1	1 1 0 0	0 1 0 1	0 0 0 0	0 0 0 0	0 0 1 1	1 1
1 0 0 0	0 0 0 0	0 1 0 0	0 1 0 1	1 1 1 1	1 1 5 0	1 0 0 0	0 1
1 6 0 0	0 0 0 0	0 1 0 0	0 1 0 1	0 0 0 0	0 1 0 0	1 0 0 0	0 1
1 0 0 0	0 0 0 0	0 1 0 0	0 1 0 1	1 1 1 1	0 1 1 0 1 1 0 0 0 1
1 0 0 0	0 0 0 0	0 1 1 1	0 0 0 1	0 0 0 1	0 1 0 0	1 5 0 0	0 1
1 2 1 1	1 1 1 1	1 1 0 0	0 0 0 1	0 0 0 0	0 1 5 9	1 0 1 0	0 1
1 0 1 0	0 0 0 0	0 0 0 0	0 0 0 1	0 0 0 1	0 1 1 1	1 1 1 0 0 1
1 0 1 0	0 0 0 0	0 0 0 0	0 0 0 2	1 1 1 1	0 1 0 0	4 5 2 0	0 1
1 0 1 0	1 1 1 1	1 0 0 0	0 0 0 1	0 1 0 1	0 0 0 1	1 1 1 7	0 1
1 0 1 0	1 0 1 0	0 0 0 0	0 0 0 1	0 1 0 1	1 1 0 0	0 0 0 0	0 1
1 0 1 0	1 0 1 1	1 1 1 1	1 0 0 1	0 1 0 0	0 0 0 0	1 1 1 1	1 1
1 0 1 0	1 0 0 0	0 0 0 0	0 0 0 2	0 0 0 0	1 1 2 1	1 0 0 0	7 1
1 2 1 2	1 1 1 1	1 1 1 0	0 0 0 2	0 0 0 1	1 0 0 0	1 5 0 0	5 1
1 0 0 0	0 0 0 0	0 0 0 0	0 0 0 1	0 0 1 1	0 0 0 0	2 0 4 9	0 1
1 1 1 1	1 1 1 0	1 0 0 0	0 0 1 1	0 0 1 9	0 1 1 2 1 1 1 1 1 1
1 0 0 0	0 0 0 0	1 0 0 0	0 0 1 0	0 1 1 7	5 1 5 0	0 0 0 0	0 1
1 0 0 1	1 1 1 1	1 1 2 1	0 1 1 2	1 1 1 1	2 1 1 0	1 1 0 1 0 1
1 0 0 1	0 0 0 0	1 0 0 1	0 0 1 0	0 0 0 1	5 0 0 5	0 1 0 1	0 1
1 0 1 1	1 1 0 0	1 0 0 1	0 0 1 1	1 1 0 1	1 1 1 1 1 1 5 1 0 1
1 0 0 0	0 0 0 0	2 0 0 1	0 0 0 0	0 0 0 0	0 0 0 0	0 5 0 1	0 1
1 1 1 1	1 1 1 1	1 1 1 1	1 1 1 1	1 1 1 1	1 1 1 1	1 1 1 1	0 1